1111111111111
10010000C0CC1
1000011111001
1P0011E00EE01
1111111111111